###############################################
#.............................................#
#.G...........................................#
#.............................................#
#...............G.........M......########.....#
#................................#..E.#.......#
#................................#............#
#.S..................G...........########.....#
#..................................G#.GG......#
###############################################